a1|HEAO 1 A-1 X-Ray Source Catalog
a1point|HEAO 1 A1 Lightcurves
a2lcpoint|HEAO 1 A2 Pointed Lightcurves
a2lcscan|HEAO 1 A2 Scanned Lightcurves
a2led|HEAO 1 A-2 LED Catalog
a2pic|HEAO 1 A-2 Piccinotti Catalog
a2point|HEAO 1 A2 Pointing
a2rtraw|HEAO 1 A2 Raw Rates
a2specback|HEAO 1 A2 Spectra Background
a2spectra|HEAO 1 A2 Spectra
a3|HEAO 1 A3 MC LASS Catalog
a4|HEAO 1 A4 X-ray
a4spectra|HEAO 1 A4 Spectra
abell|Abell Clusters
acrs|Astrographic Catalog of Reference Stars
agnsdssxmm|SDSS/XMM-Newton AGN Spectral Properties Catalog
arcquincxo|Arches and Quintuplet Clusters Chandra X-Ray Point Source Catalog
ariel3a|3rd Ariel-V SSI Catalog
ariel5|Ariel V All-Sky Monitor
ascagis|ASCA GIS Source Catalog (AMSS-I + AMSS-II)
ascagps|ASCA Galactic Plane Survey of Faint X-Ray Sources
ascalss|ASCA Large Sky Survey
ascamaster|ASCA Master Catalog
ascao|ASCA Proposals
ascaprspec|ASCA Proposal Info &amp; Abstracts
ascasis|ASCA SIS Source Catalog
asiagosn99|Asiago Supernova Catalog 1999
atnfpulsar|ATNF Pulsar Catalog
axis|AXIS XMM-Newton Source Catalog
batse4b|CGRO/BATSE 4B Catalog
batsedaily|CGRO/BATSE Daily Data
batseeocat|CGRO/BATSE Earth Occultation Catalog of Low-Energy Gamma-Ray Sources
batsegrb|CGRO/BATSE Gamma-Ray Burst Catalog
batsegrbsp|CGRO/BATSE Complete Spectral Catalog of Bright GRBs
batsepulsr|CGRO/BATSE Pulsar Observations
batsetrigs|CGRO/BATSE Trigger Data
baxgalclus|BAX X-Ray Galaxy Clusters and Groups Catalog
bbxrt|BBXRT Archive
bestars|Be Stars Catalog
bhrfscid|Byurakan/Hamburg/ROSAT Catalog of Optical IDs
bmwhricat|Brera Multi-scale Wavelet ROSAT HRI Source Catalog
bootesdf|Bootes Deep Field WSRT 1.4 GHz Source Catalog
bsc5p|Bright Star Catalog
cabscat|Chromospherically Active Binary Stars Catalog
cbatpicagn|CGRO BATSE-Observed Piccinotti Sample of Active Galactic Nuclei
cdfn2msoid|Chandra Deep Field North 2-Megasecond Optical &amp; IR Catalog
cdfsagncxo|Chandra Deep Field South AGN Spectral Properties Catalog
cenacxo|Centaurus A Galaxy Chandra X-Ray Point Source Catalog
cepaxmm|Cepheus A SFR XMM-Newton X-Ray Point Source Catalog
cepbob3cxo|Cep B/OB3 Star-Forming Region Chandra X-Ray Point Source Catalog
cfa2s|CfA Redshift Survey: South Galactic Cap Data
cgmw|Candidate Galaxies Behind the Milky Way
cgroprspec|CGRO Proposal Info &amp; Abstracts
cgrotl|CGRO Timeline
chainthcxo|Chamaeleon I North Cloud Chandra X-Ray Point Source Catalog
champhxagn|CHAMP (Chandra Multiwavelength Project) Hard X-Ray Emitting AGN
champpsc|Chandra Multiwavelength Project (ChaMP) Point Source Catalog
chanc150pc|Chandra Galactic Central 150 Parsecs Source Catalog
chandfn1ms|Chandra Deep Field North 1-Megasecond Catalog
chandfn2ms|Chandra Deep Field North 2-Megasecond Catalog
chandfs1ms|Chandra Deep Field South 1-Megasecond Catalog
chanextdfs|Chandra Extended Deep Field South Survey Point Source Catalog
changalcen|Chandra Galactic Center Point Source Catalog
chanmaster|Chandra Observations
channsgpsc|Chandra Nearby Spiral Galaxies Point Source Catalog
chansexoid|Chandra Serendipitous Extragalactic X-Ray Source ID (SEXSI) Optical Follow-Up
chansexsi|Chandra Serendipitous Extragalactic X-Ray Source ID (SEXSI) Catalog
chantypgpr|Chandra Typical Galactic Plane Region Point Source Catalog
chanulxcat|Chandra Archive Of Galaxies Ultraluminous X-Ray Source Catalog
chasfrxray|ROSAT All-Sky Survey: Chamaeleon Star Forming Region Study
chianti|Chianti Emission Line List, Version 3.01
chpngptsrc|Chandra Nearby Galaxies Point Source Catalog
clasxs|Chandra Large-Area Synoptic X-Ray Survey of Lockman Hole-NW
cmaimage|EXOSAT CMA Images for Each Pointing
cns3|Gliese Catalog of Nearby Stars, 3rd Edition
comptel|CGRO/COMPTEL Low-Level Data and Maps
cosbmaps|COS-B Map Product Catalog
cosbraw|COS-B Photon Events Catalog
coup|Chandra Orion Ultradeep Point Source Catalog
cpstars|Ap &amp; Am Stars General Catalog
crabtime|Crab Pulsar Timing
crates|CRATES Flat-Spectrum Radio Source Catalog
cvcat|Cataclysmic Variables Catalog (2006 Final Edition)
cxoxassist|Chandra XAssist Source List
cyder|Calan-Yale Deep Extragalactic Research Survey X-Ray Source Catalog
cygtevcxo|Cygnus TeV Source Chandra X-Ray Point Source Catalog
denisigal|First DENIS I-band Extragalactic Catalog
dixon|Dixon Master List of Radio Sources (Version 43)
duerbeck|Galactic Novae References Catalog
dxrbs|ROSAT Deep X-Ray Radio Blazar Survey
egret3|CGRO/EGRET Third Source Catalog
egretdata|CGRO/EGRET Photon Lists and Maps
eingalcat|Catalog of Galaxies Observed by the Einstein Observatory IPC &amp; HRI
eingalclus|Einstein Observatory Clusters of Galaxies Catalog
einlog|Einstein Observation Log
einopslgal|Einstein Survey of Optically Selected Galaxies
einstein2e|Einstein Observatory 2E Catalog of IPC X-Ray Sources
elaiscxo|ELAIS N1 and N2 Fields Chandra X-Ray Point Source Catalog
emss|Einstein Catalog IPC EMSS Survey
erosxmm|Extremely Red Objects XMM-Newton Survey Catalog
esouppsala|ESO-Uppsala ESO(B) Survey
euv|Master EUV Catalog
euvebsl|EUVE Bright Sources
euvecat2|EUVE Second Source Catalog
euvemaster|EUVE Archive and Observation Log
euverap2|EUVE Right Angle Program, 2nd Catalog
euvexrtcat|All-Sky Catalog of Faint EUV Sources
exgalemobj|Hewitt &amp; Burbidge (1991) Catalog of Extragalactic Emission-Line Objects
exms|EXOSAT ME Slew Catalog
exofot|EXOSAT Final Observation Tapes
exogps|EXOSAT/ME Galactic Plane Survey
exohgls|EXOSAT/CMA High Galactic Latitude Survey
exolog|EXOSAT Observation Log
exomaster|EXOSAT Master Observation List
exopubs|EXOSAT Bibliography
exss|Einstein Extended Source Survey
faust|Faust Far-UV Point Source Catalog
first|Faint Images of the Radio Sky at Twenty cm Source Catalog (FIRST)
flarestars|UV Cet-type Flare Stars &amp; Related Objects Catalog
fpcsfits|Einstein FPCS Events Files
fsvsclustr|Faint Sky Variability Survey Catalog of Galaxy Clusters and Rich Groups
fuselog|Far Ultraviolet Explorer (FUSE) Observation Log
gb6|Green Bank 6-cm (GB6) Radio Source Catalog
gc47tuccxo|47 Tuc Globular Cluster Chandra X-Ray Point Source Catalog
gcps|Galactic Center P-Band (330 MHz) Survey
gcvs|General Catalog of Variable Stars, Version 4.2
gcvsegsn|General Catalog of Variable Stars (GCVS4.2): Extragalactic Supernovae
gcvsegvars|General Catalog of Variable Stars (GCVS4.2): Extragalactic Variables
gcvsnsvars|General Catalog of Variable Stars (GCVS4.2): Suspected Variable Stars
gingabgd|Ginga Background Lightcurves &amp; Spectra
gingalac|Ginga Source Lightcurves &amp; Spectra
gingalog|Ginga LAC Log
gingamode|Ginga LAC Mode Catalog
gingaraw|Ginga LAC Raw Data
globclust|Milky Way Globular Clusters Catalog (February 2003 Version)
gpa|First Galactic Plane Survey at 8.35 and 14.35 GHz
gs|EXOSAT GSPC Spectra and Lightcurves
gusbad|GRBs Uniformly Selected from BATSE Archival Data (Version 2.1)
gwsstrpcxo|Groth-Westphal Strip Chandra X-Ray Point Source Catalog
hbc|Herbig &amp; Bell Catalog of Orion Pop. Emission-Line Stars
hcg|Hickson Compact Groups of Galaxies (HCG) Catalog
hcggalaxy|Hickson Compact Groups of Galaxies (HCG) Individual Galaxies Data
hdec|Henry Draper Extension Charts Catalog
hete2gcn|HETE-2 GCN Triggers Catalog
hete2grb|HETE-2 Gamma-Ray Bursts
hete2tl|HETE-2 Timeline
hic|Hipparcos Input Catalog
hiiregion|Sharpless H II Regions
hipparcos|Hipparcos Main Catalog
hmxbcat|Catalog of High-Mass X-Ray Binaries in the Galaxy (4th Ed.)
hrasscat|Hamburg/RASS Catalog: X-Ray Sources
hrassoptid|Hamburg/RASS Catalog: Optical Identifications
hricfa|Einstein Catalog HRI CFA Sources
hrideep|Einstein Catalog HRI Deep Survey
hriexo|Einstein Catalog HRI ESTEC Sources
hriimage|Einstein HRI Images
hriphot|Einstein HRI Photon Event Data
hstaec|HST Archived Exposures Catalog
hstpaec|HST Planned and Archived Observations
hubbleudf|Hubble Ultra Deep Field Catalog
hyadesxray|ROSAT All-Sky Survey: Hyades Cluster Region
ibiscat3|Third IBIS/ISGRI Soft Gamma-Ray Survey Catalog
ic348cxo|IC 348 Chandra X-Ray Point Source Catalog
infrared|Catalog of Infrared Observations (CIO), Edition 5
intbsc|INTEGRAL Bright Source Catalog
integralao|INTEGRAL Observing Program
intgccat|INTEGRAL IBIS Hard X-Ray Survey of Galactic Center
intpublic|INTEGRAL Public Data Results Catalog
intrefcat|INTEGRAL Reference Catalog
intscw|INTEGRAL Science Window Data
intscwpub|INTEGRAL Public Pointed Science Window Data
intspiagrb|INTEGRAL First SPI-ACS Gamma-Ray Burst Catalog
ipc|Einstein IPC Sources Catalog
ipcdeep|Einstein Catalog IPC Deep Survey
ipcimage|Einstein IPC Images
ipclxlbol|Einstein LX &amp; LBL Values for IPC O Stars
ipcostars|Einstein Count Rates for IPC O Stars
ipcphot|Einstein IPC Photon Event Data
ipcslew|Einstein Catalog IPC Slew Survey
ipcultsoft|Einstein IPC Ultrasoft Sources Catalog
ipcunscrnd|Einstein IPC Unscreened Photon Event List
ipngrb|Gamma-Ray Bursts from the Interplanetary Network
iramlog|IRAM Plateau de Bure Interferometer Observation Log
irasfsc|IRAS Faint Source Catalog, Version 2.0
iraspsc|IRAS Point Source Catalog, Version 2.0
irasssc|IRAS Serendipitous Survey Catalog
iraszsurv|IRAS 1.2-Jy Redshift Survey
isolog|ISO (Infrared Space Observatory) Observation Log
iuelog|IUE (International Ultraviolet Explorer) Final Merged Observation Log
kommersgrb|Kommers et al. (2001) BATSE Non-Triggered Gamma-Ray Burst Catalog
konus|Venera KONUS 11 &amp; 12 Bursts
kuehr|Extragalactic Radio Sources
lalaboocxo|LALA Bootes Field Chandra X-Ray Point Source Catalog
lbn|Lynds Catalog of Bright Nebulae
lbqs|Large Bright Quasar Survey
ldn|Lynds Catalog of Dark Nebulae
le|CMA Catalog Central 6 Arcmin
lmc30drcxo|LMC 30 Doradus Complex Chandra X-Ray Point Source Catalog
lmcclustrs|LMC Clusters Catalog
lmcextobj|Large Magellanic Cloud Extended Objects Catalog
lmchrixray|ROSAT HRI Catalog of LMC X-Ray Sources (Sasaki et al.)
lmcrosxray|ROSAT PSPC Catalog of LMC X-Ray Sources (Haberl &amp; Pietsch)
lmcxray|LMC X-Ray Discrete Sources
lmxbcat|Low-Mass X-Ray Binary Catalog (4th Edition, 2007)
lockmanxmm|Lockman Hole Field XMM-Newton X-Ray Point Source Catalog
lupus3xmm|Lupus 3 SFR XMM-Newton X-Ray Point Source Catalog
lyngaclust|Lynga Open Clusters Catalog
m101cxo|M 101 Chandra X-Ray Point Source Catalog
m31clustrs|M31 Globular Cluster Candidates Catalog
m31cxoxray|M31 Central Region Chandra X-Ray Point Source Catalog
m31rosxray|ROSAT PSPC M31 Source Catalog
m31stars|M31 Field Brightest Stars Catalog
m31stars2|MIT/Amsterdam M31 Survey
m31xmmxray|XMM-Newton M31 Survey Catalog
m33cxoxray|M33 Chandra X-Ray Point Source Catalog
m33xmm2|M33 XMM-Newton X-Ray Variability Source Catalog
m33xmmxray|XMM-Newton M33 Survey Catalog
m51cxo|M 51 Chandra X-Ray Discrete Source Catalog
m67cxo|M 67 Chandra X-Ray Point Source Catalog
m81cxo|M 81 Chandra X-Ray Discrete Source Catalog
m87cxo|M 87 Chandra X-Ray Point Source Catalog
macs|Magellanic Catalog of Stars
maghmxbcat|Magellanic Clouds High-Mass X-Ray Binaries Catalog
magpis|Multi-Array Galactic Plane Imaging Survey
maranoxmm|Marano Field XMM-Newton X-Ray Source Optical Counterparts
markarian|Markarian Galaxies
mcg|Morphological Galaxy Catalog
mcksion|McCook-Sion White Dwarf Catalog (Web Version)
me|EXOSAT ME Spectra and Lightcurves
messier|Messier Nebulae
mggammacat|Gamma-Ray Source Summary Catalog (Macomb &amp; Gehrels 1999 &amp; 2001)
mggammadet|Gamma-Ray Source Detailed Catalog (Macomb &amp; Gehrels 1999)
mitgb6cm|MIT-Green Bank 5-GHz Survey Catalog
monr2cxo|Monoceros R2 Cloud Chandra X-Ray Point Source Catalog
mostsnrcat|Molonglo Observatory Synthesis Telescope Supernova Remnant Catalog
mpcraw|Einstein MPC Raw Data
mrc|Molonglo Reference Catalog of Radio Sources
msxpsc|Midcourse Space Experiment (MSX) Point Source Catalog, V2.3
ngc1333cxo|NGC 1333 Chandra X-Ray Point Source Catalog
ngc2000|NGC2000.0: Complete New General Catalog and Index Catalog
ngc2024cxo|NGC 2024 Chandra X-Ray Point Source Catalog
ngc2264cx2|NGC 2264 Chandra X-Ray Point Source Catalog 2
ngc2264cxo|NGC 2264 Chandra X-Ray Point Source Catalog
ngc2264xmm|NGC 2264 XMM-Newton X-Ray Point Source Catalog
ngc2362cxo|NGC 2362 Chandra X-Ray Point Source Catalog
ngc2516cxo|NGC 2516 Chandra X-Ray Point Source Catalog
ngc2516xmm|NGC 2516 Cluster XMM-Newton X-Ray Point Source Catalog
ngc2547xmm|NGC 2547 XMM-Newton X-Ray Point Source Catalog
ngc4472cxo|NGC 4472 Chandra X-Ray Point Source Catalog
ngc4649cxo|NGC 4649 Chandra X-Ray Discrete Source Catalog
ngc6231xmm|NGC 6231 XMM-Newton X-Ray Source Catalog
ngc6530cxo|NGC 6530 Chandra X-Ray Point Source Catalog
ngc6530oid|NGC 6530 Chandra Point Source Optical/IR Identifications Catalog
ngc6530xmm|NGC 6530 XMM-Newton X-Ray Point Source Catalog
nltt|NLTT Catalog &amp; First Supplement
noras|Northern ROSAT All-Sky (NORAS) Galaxy Cluster Survey Catalog
north20cm|20cm Radio Catalog
north6cm|6cm Radio Catalog
nvss|NRAO VLA Sky Survey Catalog
omc2p3cxo|OMC-2 and OMC-3 Chandra X-Ray Point Source Catalog
omegcenxmm|Omega Centauri XMM-Newton X-Ray Point Source Catalog
onccxoopt|Orion Nebula Cluster Chandra HRC Optical Sample
onccxoxray|Orion Nebula Cluster Chandra HRC X-Ray Point Source Catalog
openclust|New Optically Visible Open Clusters and Candidates Catalog
orionffcxo|Orion Flanking Fields Chandra X-Ray Point Source Catalog
orionxray|ROSAT Survey of the Orion Nebula
orionxstar|ROSAT HRI Orion Group 1 Stars
oso8alc|OSO8 A Detector Lightcurves
oso8bclc|OSO8 B&amp;C Detector Lightcurves
oso8pharaw|OSO8 GCXSE Raw PHA
oso8rtraw|OSO8 GCXSE Raw Rates
osse|CGRO/OSSE Observations
ostars|Galactic O Stars Catalog
pg|PG Catalog of UV-excess Objects
pgc2003|Principal Galaxy Catalog (PGC) 2003
phebus|Granat Phebus Gamma-Ray Bursts
pkscat90|Parkes Southern Radio Sources
pleiadxray|ROSAT PSPC Catalog of the Pleiades (Micela et al. 1996)
plnebulae|Galactic Planetary Nebulae Catalog
pmn|Parkes-MIT-NRAO (PMN) Surveys
pmpulsar|Parkes Multibeam Survey New Pulsar Catalog
pmsucat|Palomar/MSU Nearby Star Survey
ppm|Positions and Proper Motions Catalog
pulsar|Pulsar Catalog
pvogrb|PVO Gamma-Ray Bursts
qorgcat|All-Sky Optical Catalog of Radio/X-Ray Sources
qso|Hewitt &amp; Burbidge (1993) QSO Catalog
radio|Master Radio Catalog
rassbsc|ROSAT All-Sky Survey: Bright Sources
rasscals|ROSAT All-Sky Survey CALS Galaxy Groups Catalog
rasscns3|ROSAT All-Sky Survey: Nearby Stars
rassdssagn|ROSAT All-Sky Survey and SDSS DR5 Sample of X-Ray Emitting AGN
rassdwarf|ROSAT All-Sky Survey: A-K Dwarfs/Subgiants
rassebcs|ROSAT All-Sky Survey Extended Brightest Cluster Sample
rassfsc|ROSAT All-Sky Survey: Faint Sources
rassgb|RASS/Green Bank Catalog
rassgiant|ROSAT All-Sky Survey: Giants &amp; Supergiants
rasshgsoft|ROSAT All-Sky Survey: Soft High Galactic-Latitude X-Ray Sources
rassmaster|ROSAT All-Sky Survey Archival Data
rassnorsam|ROSAT All-Sky Survey Completely Identified Northern Sample
rassob|ROSAT All-Sky Survey: OB Stars
rassvars|RASS X-Ray Variable Sources Catalog
rasswd|ROSAT All-Sky Survey: White Dwarfs
rbs|ROSAT Bright Survey (Schwope et al. 2000)
rbscnvss|ROSAT All-Sky Survey/NVSS Bright X-Ray Source Sample
rc3|Third Reference Catalog of Bright Galaxies
rcw38cxo|RCW 38 Chandra X-Ray Point Source Catalog
reflex|ROSAT-ESO Flux-Limited X-Ray (REFLEX) Galaxy Cluster Survey
revisedlhs|Revised Luyten Half-Second (LHS) Catalog
rhoophcxo|Rho Ophiuchi SFR Chandra X-Ray Point Source Catalog
rittercv|Ritter Cataclysmic Binaries Catalog (7.8 Edition)
ritterlmxb|Ritter Low-Mass X-Ray Binaries Catalog (7.8 Edition)
ritterrbin|Ritter Binaries Related to CVs Catalog (7.8 Edition)
rixos|ROSAT International X-Ray/Optical Survey Source Catalog
ros13hrxmm|ROSAT 13-hour Field XMM-Newton X-Ray Source Catalog
rosatlog|ROSAT Observation Log
rosatrlq|ROSAT Radio-Loud Quasars Catalog
rosatrqq|ROSAT Radio-Quiet Quasars Catalog
rosatxuv|ROSAT XUV Pointed Phase
rosgalclus|ROSAT PSPC Catalog of Clusters of Galaxies
roshri|ROSAT Results Archive Sources for the HRI
roshritotal|ROSAT Complete Results Archive Sources for the HRI
rosmaster|ROSAT Archival Data
rosnepagn|ROSAT North Ecliptic Pole Survey Active Galactic Nuclei Catalog
rosnepoid|ROSAT North Ecliptic Pole Survey Optical Identifications
rosnepxray|ROSAT North Ecliptic Pole Survey X-Ray Source Catalog
rosprspec|ROSAT Proposal Abstracts
rospspc|ROSAT Results Archive Sources for the PSPC
rospspctotal|ROSAT Complete Results Archive Sources for the PSPC
roswfc2re|ROSAT Catalog WFC 2RE Sources
sa57xmm|Selected Area 57 XMM-Newton X-Ray Source Catalog
sacy|SACY (Search for Associations Containing Young Stars) Catalog
saisncat|Sternberg Astronomical Institute Catalog of Supernovae
sao|Smithsonian Astrophysical Observatory Star Catalog
sas2maps|SAS-2 Map Product Catalog
sas2raw|SAS-2 Photon Events Catalog
sas3ylog|SAS-3 Y-Axis Pointed Obs Log
sax2to10|BeppoSAX 2-10 keV Survey
saxao|BeppoSAX Approved Pointings
saxnfilog|BeppoSAX NFI Archive and Observation Log
saxwfclog|BeppoSAX WFC Observation Log
sborbitcat|Spectroscopic Binary Orbits Ninth Catalog
sc_cma_view|EXOSAT/CMA Sources
sdssnbcqsc|Sloan Digital Sky Survey NBC Quasar Candidate Catalog
sdssquasar|Sloan Digital Sky Survey Quasar Catalog (5th Data Release)
sdsswdsd|Sloan Digital Sky Survey DR4 White Dwarf &amp; Hot Subdwarf Catalog
shk|Shakbazian Compact Groups of Galaxies
shkgalaxy|Shakhabazian (Shk) Compact Groups of Galaxies: Individual Galaxies Data
sigorixmm|Sigma Orionis Cluster XMM-Newton X-Ray Point Source Catalog
smcclustrs|SMC &amp; Bridge Clusters Catalog
smcradio|Small Magellanic Cloud ATCA Radio Continuum Sources
smcrosxray|ROSAT PSPC Survey of the Small Magellanic Cloud
smcrosxry2|ROSAT PSPC Catalog of SMC X-Ray Sources (Haberl et al)
smcstars|SMC Probable Member Stars Catalog
smcstars2|SMC H-Alpha Emission Stars/Nebulae
smcxray|SMC X-Ray Discrete Sources
smmgrs|GRS Gamma-Ray Bursts
snrgreen|Green Catalog of Galactic SNRs (December 2001 Version)
spicescxo|SPICES Lynx Field Chandra X-Ray Source Catalog
spitzmastr|Spitzer Space Telescope Observation Log
sss|Einstein SSS Spectra and Lightcurves
sssraw|Einstein SSS and MPC Raw Data
sterngrb|Stern et al. (2001) BATSE Gamma-Ray Burst Catalog
subpfclog|Subaru Prime Focus Camera (Suprime-Cam) Exposures Log
sumss|Sydney University Molonglo Sky Survey (SUMSS) Source Catalog
suzamaster|Suzaku Master Catalog
suzaxislog|Suzaku XIS Configuration Log
swiftbalog|Swift BAT Instrument Log
swiftmastr|Swift Master Catalog
swifttdrss|Swift TDRSS Messages
swiftuvlog|Swift UVOT Instrument Log
swiftxrlog|Swift XRT Instrument Log
swirecxo|Spitzer Wide-Area IR Extra-Galactic Survey Chandra X-Ray Sources
symbiotics|Symbiotic Stars Catalog
tartarus|Tartarus: Reduced ASCA AGN Data (Version 3.1)
taurusxmm|Taurus Molecular Cloud XMM-Newton X-Ray Source Catalog
td1|TD1 Stellar Ultraviolet Fluxes Catalog
texas|Texas Survey of Radio Sources at 365 MHz
tgs|EXOSAT TGS L and R Orders
tgs2|EXOSAT TGS Spectra and Lightcurves
trifidcxo|Trifid Nebula (M 20) Chandra X-Ray Point Source Catalog
twosigma|Einstein Two-Sigma Catalog
tycho2|Tycho-2 Catalog of the 2.5 Million Brightest Stars
ugc|Uppsala General Catalog of Galaxies
uhuru4|Uhuru Fourth (4U) Catalog
uit|Ultraviolet Imaging Telescope Near-UV Bright Objects Catalog
ulxrbcat|Ultraluminous X-Ray Sources in External Galaxies Catalog
upprscoxmm|Upper Sco XMM-Newton X-Ray Point Source Catalog
uzc|Updated Zwicky Catalog
vela5b|Vela 5B All-Sky Monitor Lightcurves
veroncat|Veron Catalog of Quasars &amp; AGN, 12th Edition
vlacosmos|VLA-COSMOS Large Project 1.4-GHz Source Catalog
vlanep|1.5-GHz VLA-NEP Survey
vlss|VLA Low-Frequency Sky Survey Discrete Source Catalog
wackerling|Wackerling Catalog of Early-Type Emission-Line Stars
warps|Wide Angle ROSAT Pointed Survey, First Phase (WARPS-I)
wbhgp20cm|New Catalog of Compact 20cm Sources in the Galactic Plane
wbhgp6cm|New Catalog of Compact 6cm Sources in the Galactic Plane
wbl|WBL Poor Galaxy Clusters Catalog (White et al. 1999)
wblgalaxy|WBL Individual Galaxies Data Catalog (White et al. 1999)
wds|Washington Double Star Catalog
wenss|Westerbork Northern Sky Survey
wfcpoint|ROSAT Archival WFC EUV Data
wgacat|ROSAT Catalog PSPC WGA Sources
woodebcat|Wood Interacting Binaries Catalog
woolley|Woolley Catalog of Stars within 25 Parsecs
wrcat|The VIIth Catalog of Galactic Wolf-Rayet Stars
xbootes|XBOOTES: NDWFS Bootes Field X-Ray Point Source Catalog
xbootesoid|XBOOTES: NDWFS Bootes Field Optical &amp; Near IR Counterparts
xcopraw|Copernicus X-Ray Observations
xmdsvvds4s|XMM-Newton Medium Deep Survey/VIRMOS VLT Deep Survey 4-Sigma Catalog
xmmao|XMM-Newton Accepted Targets
xmmbss|XMM-Newton Bright Serendipitous Survey
xmmcfrscat|XMM-Newton/Canada-France Redshift Survey Fields X-Ray Sources
xmmcfrsoid|XMM-Newton/Canada-France Redshift Survey Fields Optical Identifications
xmmgps|XMM-Newton Galactic Plane Survey - XGPS
xmmmaster|XMM-Newton Master Log &amp; Public Archive
xmmslewcln|XMM-Newton Slew Survey Clean Source Catalog, v1.1
xmmslewful|XMM-Newton Slew Survey Full Source Catalog, v1.1
xmmssc|XMM-Newton Serendipitous Source Catalog, Second Version
xmmxassist|XMM-Newton XAssist Source List
xray|Master X-Ray Catalog
xrbcat|X-Ray Binaries Catalog
xteao|XTE Proposal Info &amp; Abstracts
xteasmlong|XTE All-Sky Monitor Long-Term Observed Sources
xteasmquick|XTE All-Sky Monitor Quicklook Observed Data
xteassagn|XTE All-Sky Slew Survey AGN Catalog
xteasscat|XTE All-Sky Slew Survey Catalog
xteindex|XTE Target Index Catalog
xtemaster|XTE Master Catalog
xteslew|XTE Archived Public Slew Data
zcat|CfA Redshift Catalog (June 1995 Version)
zwclusters|Zwicky Clusters
